-------------------------
-                       -
-                       -
-                       -
-                       -
-                       -
-                       -
-                       -
-                       -
-                       -
-                       -
-G                      -
-                       -
-                       -
-                       -
-                       -
-                       -
-                       -
-                      *-
-------------------------