-------------------------
-                       -
-                       -
-                       -
-                       -
-                       -
-                       -
-                       -
-                       -
-                       -
-                       -
-                       -
-                       -
-                       -
-                       -
-                       -
-                       -
-                       -
-    *  *  *  *  *     G-
-------------------------