-------------------------
-                       -
-                       -
-                       -
-                       -
-                       -
-                       -
-                       -
-                       -
-                      G-
-                      --
-                    -- -
-                  --   -
-                --     -
-              --       -
-            --         -
-          --           -
-        --             -
-      --               -
-------------------------