-------------------------
-                       -
-                       -
-                       -
-                       -
-                       -
-                      G-
-                      --
-                       -
-               -       -
-                       -
-        -              -
-                       -
--                      -
-                       -
-                       -
-                       -
-                       -
-                      *-
-------------------------