-------------------------
-                       -
-                       -
-                       -
-                       -
-                       -
-                       -
-                       -
-                       -
-                       -
-                       -
-                       -
-                       -
-                       -
-                       -
-                       -
-                       -
-                       -
-         ****         G-
-------------------------