------------------------------------------------
-                                              -
-                                              -
-                                              -
-                                              -
-                                              -
-                                              -
-                                              -
-      G                                       -
-      --    --                                -
-                                              -
-                   *                          -
-                    --                        -
-                              --              -
-                                     *        -
-                                    ----      -
-                                             --
-                                              -
-                                              -
-                        *                     -
-                        *                    --
-                        *                     -
-                        *                     -
-                      --*--        ----       -
-                                              -
-          *    *                              -
--       ---    ---                            -
-                                              -
-                                              -
-                                              -
-                                              -
--                                             -
-                                              -
-                                              -
-                                              -
-                                              -
------------------------------------------------