-------------------------
-                       -
-                      G-
-                      --
-                       -
-                       -
-                      --
-                       -
-                       -
-                      --
-                       -
-                       -
-                      --
-                       -
-                       -
-                      --
-                       -
-                       -
-                       -
-------------------------