-------------------------
-                       -
-                       -
-                       -
-                       -
-                       -
-                       -
-                       -
-                       -
-                       -
-                       -
-                       -
-                       -
-                       -
-                       -
-                       -
-                       -
-                       -
-          *           G-
-------------------------