-------------------------
-       G               -
-                       -
-     ----              -
-                       -
-                       -
-                       -
-              --       -
-                       -
-      --               -
-                       -
-                       -
-                       -
-      --               -
-                       -
-                       -
-                       -
-      --               -
-                       -
-------------------------