-------------------------
-                       -
-                       -
-                       -
-                       -
-                       -
-                       -
-                       -
-                      G-
-                     ---
-                       -
-                       -
-                       -
-                --     -
-                       -
-                       -
-         --            -
-                       -
-                       -
-------------------------